player,pos,age,team,game,gamestarted,minutesplayed,fieldgoalmade,fieldgoalattempt,fieldgoalpercentage,threepointmade,threepa,threepointattempt,twopointmade,twopointattempt,twopointpercentage,efficencyfgpercentage,freethrowsmade,freethrowattempt,freethrowpercentage,offensiverebound,deffensiverebound,totalrebound,assist,steal,block,turnover,personalfoul,points
Steven Adams,C,27,NOP,27,27,760,94,156,0.603,0,1,0.0,94,155,0.606,0.603,29,62,0.46800000000000000,116,123,239,58,26,15,46,51,217
Bam Adebayo,C,23,MIA,27,27,908,198,347,0.5710000000000000,2,5,0.4,196,342,0.573,0.573,136,161,0.845,53,199,252,149,25,27,82,69,534
LaMarcus Aldridge,C,35,SAS,18,18,480,107,225,0.47600000000000000,24,67,0.358,83,158,0.525,0.529,16,21,0.762,15,63,78,35,7,16,16,27,254
Nickeil Alexander-Walker,SG,22,NOP,23,3,441,77,188,0.41,24,87,0.276,53,101,0.525,0.473,25,32,0.7810000000000000,5,56,61,46,25,8,30,40,203
Grayson Allen,SG,25,MEM,19,8,454,60,140,0.429,44,101,0.436,16,39,0.41,0.586,33,37,0.892,7,48,55,39,19,3,20,24,197
Jarrett Allen,C,22,TOT,28,10,734,122,190,0.642,1,4,0.25,121,186,0.6510000000000000,0.645,100,132,0.758,82,170,252,45,13,46,43,44,345
Jarrett Allen,C,22,CLE,16,5,414,78,125,0.624,1,4,0.25,77,121,0.636,0.628,54,71,0.7610000000000000,44,83,127,25,6,27,21,23,211
Kyle Anderson,PF,27,MEM,24,24,675,120,257,0.467,40,103,0.38800000000000000,80,154,0.519,0.545,50,64,0.7810000000000000,22,128,150,92,27,18,34,43,330
Giannis Antetokounmpo,PF,26,MIL,28,28,944,287,516,0.556,31,111,0.27900000000000000,256,405,0.632,0.586,179,281,0.637,48,272,320,165,36,36,104,89,784
Thanasis Antetokounmpo,SF,28,MIL,19,0,157,19,32,0.594,2,7,0.28600000000000000,17,25,0.68,0.625,5,9,0.556,16,18,34,15,5,3,15,27,45
Carmelo Anthony,PF,36,POR,27,3,683,125,316,0.396,46,122,0.377,79,194,0.40700000000000000,0.46800000000000000,64,76,0.8420000000000000,15,79,94,35,21,21,25,57,360
Cole Anthony,PG,20,ORL,25,17,667,101,269,0.375,27,83,0.325,74,186,0.39800000000000000,0.426,46,55,0.836,20,91,111,94,17,11,51,51,275
OG Anunoby,SF,23,TOR,19,19,646,95,198,0.48,44,108,0.40700000000000000,51,90,0.5670000000000000,0.591,38,50,0.76,29,84,113,29,36,11,31,54,272
Ryan Arcidiacono,PG,26,CHI,11,0,107,9,24,0.375,6,16,0.375,3,8,0.375,0.5,4,5,0.8,1,21,22,17,3,0,2,10,28
D.J. Augustin,PG,33,MIL,28,0,505,49,146,0.336,35,95,0.368,14,51,0.275,0.455,34,38,0.895,11,25,36,82,13,1,22,20,167
Deni Avdija,SF,20,WAS,22,16,503,56,132,0.424,27,76,0.355,29,56,0.518,0.527,11,19,0.579,12,96,108,35,17,4,18,61,150
Deandre Ayton,C,22,PHX,27,27,866,164,278,0.59,4,16,0.25,160,262,0.611,0.597,44,61,0.721,99,231,330,48,8,27,57,91,376
Dwayne Bacon,SG,25,ORL,29,20,721,118,279,0.423,31,83,0.373,87,196,0.444,0.478,44,55,0.8,12,79,91,30,22,3,20,48,311
Marvin Bagley III,PF,21,SAC,26,26,647,135,281,0.48,28,72,0.389,107,209,0.512,0.53,40,78,0.513,58,136,194,24,12,12,38,64,338
LaMelo Ball,PG,19,CHA,28,8,776,152,348,0.43700000000000000,51,144,0.354,101,204,0.495,0.51,55,69,0.797,43,130,173,171,43,10,75,74,410
Lonzo Ball,PG,23,NOP,25,25,772,129,304,0.424,72,189,0.381,57,115,0.496,0.5430000000000000,20,27,0.741,16,92,108,118,31,12,51,62,350
Mo Bamba,C,22,ORL,13,0,113,28,54,0.519,4,15,0.267,24,39,0.615,0.556,3,5,0.6,16,33,49,4,2,10,4,14,63
Desmond Bane,SG,22,MEM,20,2,456,75,155,0.484,41,85,0.48200000000000000,34,70,0.486,0.616,14,17,0.8240000000000000,9,44,53,32,13,3,23,37,205
Harrison Barnes,PF,28,SAC,27,27,948,142,296,0.48,45,116,0.38800000000000000,97,180,0.539,0.556,97,115,0.843,29,139,168,91,21,5,38,31,426
RJ Barrett,SG,20,NYK,30,30,1012,187,437,0.428,31,102,0.304,156,335,0.466,0.46300000000000000,89,120,0.742,39,147,186,92,22,6,57,74,494
Will Barton,SF,30,DEN,25,21,744,109,250,0.436,40,99,0.40400000000000000,69,151,0.457,0.516,33,44,0.75,12,81,93,80,20,11,38,46,291
Keita Bates-Diop,SF,25,SAS,8,0,27,0,9,0.0,0,4,0.0,0,5,0.0,0.0,5,6,0.833,1,2,3,2,1,0,0,0,5
Nicolas Batum,SF,32,LAC,27,27,806,90,183,0.49200000000000000,57,125,0.456,33,58,0.569,0.648,26,30,0.867,24,108,132,63,37,10,19,46,263
Aron Baynes,C,34,TOR,26,24,485,62,149,0.41600000000000000,12,54,0.222,50,95,0.526,0.456,9,11,0.818,38,100,138,27,7,9,23,66,145
Kent Bazemore,SF,31,GSW,27,0,448,68,132,0.515,28,61,0.45900000000000000,40,71,0.563,0.621,24,30,0.8,13,71,84,43,22,16,28,60,188
Darius Bazley,PF,20,OKC,28,28,872,127,323,0.39300000000000000,42,147,0.28600000000000000,85,176,0.483,0.45800000000000000,46,60,0.767,15,192,207,51,13,20,49,28,342
Bradley Beal,SG,27,WAS,24,24,846,273,577,0.473,60,178,0.337,213,399,0.534,0.525,180,201,0.8960000000000000,33,91,124,112,32,12,75,60,786
Malik Beasley,SG,24,MIN,29,28,951,224,492,0.455,100,251,0.39800000000000000,124,241,0.515,0.557,59,70,0.843,26,115,141,73,25,5,48,50,607
DeAndre' Bembry,SF,26,TOR,20,1,298,35,57,0.614,8,16,0.5,27,41,0.659,0.684,6,11,0.545,8,24,32,34,12,5,13,26,84
D?vis Bert?ns,PF,28,WAS,23,3,593,77,202,0.381,68,180,0.37800000000000000,9,22,0.409,0.55,43,52,0.8270000000000000,10,62,72,23,17,7,13,58,265
Patrick Beverley,PG,32,LAC,20,20,483,54,124,0.435,35,79,0.44300000000000000,19,45,0.42200000000000000,0.5770000000000000,22,29,0.759,20,64,84,43,20,15,15,67,165
Saddiq Bey,SF,21,DET,26,9,529,76,182,0.418,50,121,0.413,26,61,0.426,0.555,38,46,0.826,11,84,95,25,14,1,19,35,240
Khem Birch,C,28,ORL,29,0,631,72,140,0.514,3,12,0.25,69,128,0.539,0.525,46,62,0.742,80,93,173,34,20,21,19,48,193
Goga Bitadze,C,21,IND,13,0,124,22,38,0.579,2,12,0.16700000000000000,20,26,0.769,0.605,9,12,0.75,9,20,29,3,3,14,4,23,55
Bismack Biyombo,C,28,CHA,26,16,585,69,119,0.58,0,1,0.0,69,118,0.585,0.58,21,47,0.447,57,94,151,34,6,32,23,61,159
Nemanja Bjelica,PF,32,SAC,14,1,246,41,88,0.466,9,35,0.257,32,53,0.604,0.517,24,31,0.774,13,44,57,31,2,2,18,27,115
Eric Bledsoe,SG,31,NOP,27,26,780,124,284,0.43700000000000000,59,147,0.401,65,137,0.474,0.54,35,54,0.648,13,83,96,99,18,7,47,40,342
Bogdan Bogdanovi?,SG,28,ATL,9,2,213,30,78,0.385,21,58,0.36200000000000000,9,20,0.45,0.519,8,9,0.889,2,32,34,19,4,1,11,18,89
Bojan Bogdanovi?,SF,31,UTA,29,29,891,146,351,0.41600000000000000,74,191,0.387,72,160,0.45,0.521,76,88,0.8640000000000000,14,101,115,61,12,1,44,44,442
Bol Bol,PF,21,DEN,12,2,65,7,16,0.43800000000000000,2,6,0.33300000000000000,5,10,0.5,0.5,1,2,0.5,0,9,9,2,1,4,5,7,17
Isaac Bonga,SF,21,WAS,17,7,230,14,36,0.389,9,22,0.409,5,14,0.35700000000000000,0.514,2,3,0.667,8,30,38,9,4,4,7,28,39
Devin Booker,SG,24,PHX,23,23,810,206,419,0.49200000000000000,47,133,0.353,159,286,0.556,0.5480000000000000,102,123,0.8290000000000000,4,81,85,101,20,7,81,76,561
Chris Boucher,C,28,TOR,29,0,676,137,259,0.529,45,104,0.433,92,155,0.594,0.616,69,92,0.75,56,140,196,30,15,59,20,77,388
Avery Bradley,SG,30,MIA,10,1,211,31,66,0.47,16,38,0.42100000000000000,15,28,0.536,0.591,7,9,0.778,2,16,18,14,7,1,9,26,85
Tony Bradley,C,23,PHI,10,1,117,19,36,0.528,0,1,0.0,19,35,0.5430000000000000,0.528,3,5,0.6,21,29,50,6,3,6,1,11,41
Mikal Bridges,SF,24,PHX,27,27,898,137,272,0.504,53,133,0.39800000000000000,84,139,0.604,0.601,55,66,0.833,37,107,144,57,17,26,20,50,382
Miles Bridges,PF,22,CHA,28,2,747,105,224,0.469,36,99,0.364,69,125,0.552,0.5490000000000000,31,33,0.9390000000000000,37,125,162,54,20,22,49,68,277
Malcolm Brogdon,PG,28,IND,29,29,1045,236,534,0.442,77,195,0.395,159,339,0.469,0.514,77,85,0.9060000000000000,22,118,140,190,37,8,60,54,626
Dillon Brooks,SF,25,MEM,24,24,700,147,370,0.397,46,144,0.319,101,226,0.447,0.45900000000000000,40,50,0.8,25,53,78,62,32,9,55,79,380
Bruce Brown,PG,24,BRK,27,14,518,74,135,0.5480000000000000,4,23,0.174,70,112,0.625,0.563,23,34,0.6760000000000000,36,82,118,28,18,10,22,50,175
Jaylen Brown,SG,24,BOS,26,26,868,257,508,0.506,63,154,0.409,194,354,0.5480000000000000,0.568,96,125,0.768,31,113,144,93,31,15,74,77,673
Sterling Brown,SG,25,HOU,26,1,556,72,160,0.45,40,98,0.408,32,62,0.516,0.575,10,10,1.0,20,81,101,46,25,7,17,53,194
Troy Brown Jr.,SF,21,WAS,13,0,205,22,62,0.355,11,36,0.306,11,26,0.423,0.444,7,12,0.583,8,37,45,13,2,2,12,23,62
Jalen Brunson,PG,24,DAL,24,6,578,103,200,0.515,26,68,0.382,77,132,0.583,0.58,48,54,0.889,5,71,76,87,9,0,29,36,280
Thomas Bryant,C,23,WAS,10,10,271,59,91,0.648,9,21,0.429,50,70,0.7140000000000000,0.698,16,24,0.667,18,43,61,15,4,8,11,31,143
Reggie Bullock,SF,29,NYK,25,25,669,78,190,0.41100000000000000,44,115,0.38300000000000000,34,75,0.45300000000000000,0.526,13,16,0.813,7,80,87,34,18,6,18,62,213
Trey Burke,PG,28,DAL,27,0,466,79,178,0.444,36,91,0.396,43,87,0.494,0.545,23,27,0.852,4,26,30,43,21,2,15,40,217
Alec Burks,SG,29,NYK,18,3,459,64,162,0.395,36,88,0.409,28,74,0.37800000000000000,0.506,35,43,0.8140000000000000,9,74,83,38,15,5,20,31,199
Jimmy Butler,SF,31,MIA,17,17,562,102,232,0.44,4,25,0.16,98,207,0.473,0.44800000000000000,116,136,0.853,32,101,133,131,32,6,37,20,324
Bruno Caboclo,PF,25,HOU,6,0,36,8,17,0.47100000000000000,0,5,0.0,8,12,0.667,0.47100000000000000,1,2,0.5,3,11,14,1,0,2,4,6,17
Kentavious Caldwell-Pope,SG,27,LAL,26,26,655,78,176,0.44300000000000000,40,97,0.41200000000000000,38,79,0.48100000000000000,0.557,25,29,0.862,9,48,57,34,19,8,27,42,221
Facundo Campazzo,PG,29,DEN,25,1,350,38,96,0.396,24,64,0.375,14,32,0.43800000000000000,0.521,22,29,0.759,5,15,20,48,23,4,17,44,122
Vlatko ?an?ar,PF,23,DEN,13,0,45,3,14,0.214,1,8,0.125,2,6,0.33300000000000000,0.25,1,2,0.5,3,9,12,1,4,2,5,3,8
Vernon Carey Jr.,C,19,CHA,3,0,6,1,3,0.33300000000000000,0,1,0.0,1,2,0.5,0.33300000000000000,1,2,0.5,2,1,3,1,0,1,0,0,3
Jevon Carter,PG,25,PHX,23,0,256,25,73,0.342,14,49,0.28600000000000000,11,24,0.45800000000000000,0.43800000000000000,2,2,1.0,3,29,32,26,10,6,5,27,66
Wendell Carter Jr.,C,21,CHI,16,16,425,76,138,0.551,4,15,0.267,72,123,0.585,0.565,52,72,0.722,35,89,124,35,11,11,31,48,208
Michael Carter-Williams,SG,29,ORL,10,5,246,29,82,0.354,2,17,0.11800000000000000,27,65,0.415,0.366,17,23,0.7390000000000000,18,29,47,30,5,4,16,27,77
Alex Caruso,PG,26,LAL,23,0,438,46,102,0.451,22,51,0.431,24,51,0.47100000000000000,0.5590000000000000,10,12,0.833,12,46,58,53,25,4,27,37,124
Willie Cauley-Stein,C,27,DAL,26,10,454,62,99,0.626,1,5,0.2,61,94,0.649,0.631,28,44,0.636,33,87,120,20,9,19,14,65,153
Chris Chiozza,PG,25,BRK,12,0,111,12,41,0.293,5,18,0.278,7,23,0.304,0.354,9,11,0.818,3,8,11,28,4,3,8,8,38
Marquese Chriss,PF,23,GSW,2,0,27,5,14,0.35700000000000000,1,5,0.2,4,9,0.444,0.39300000000000000,2,4,0.5,3,10,13,2,0,2,2,3,13
Gary Clark,SF,26,ORL,26,11,545,30,102,0.294,23,87,0.264,7,15,0.467,0.40700000000000000,6,7,0.857,29,64,93,24,10,5,15,29,89
Brandon Clarke,PF,24,MEM,20,13,543,111,222,0.5,11,36,0.306,100,186,0.5380000000000000,0.525,26,41,0.634,32,79,111,36,24,15,14,33,259
Jordan Clarkson,SG,28,UTA,29,0,760,194,428,0.45300000000000000,94,246,0.382,100,182,0.5490000000000000,0.563,46,48,0.958,27,92,119,61,28,7,54,41,528
Amir Coffey,SG,23,LAC,19,0,154,21,40,0.525,11,21,0.524,10,19,0.526,0.6630000000000000,3,9,0.33300000000000000,3,12,15,8,4,0,8,11,56
John Collins,PF,23,ATL,28,28,884,199,364,0.547,39,95,0.41100000000000000,160,269,0.595,0.6,72,83,0.867,61,151,212,44,13,28,39,95,509
Mike Conley,PG,33,UTA,23,23,674,131,291,0.45,64,156,0.41,67,135,0.496,0.56,53,65,0.815,23,61,84,134,32,2,46,42,379
Pat Connaughton,SG,28,MIL,26,0,504,58,132,0.439,34,89,0.382,24,43,0.5580000000000000,0.568,7,10,0.7,22,76,98,37,17,12,7,36,157
Quinn Cook,PG,27,LAL,16,0,62,12,26,0.462,5,13,0.385,7,13,0.5380000000000000,0.5580000000000000,4,5,0.8,0,5,5,5,1,1,3,2,33
DeMarcus Cousins,C,30,HOU,25,11,506,79,210,0.376,39,116,0.336,40,94,0.426,0.469,44,59,0.746,30,161,191,60,21,18,39,74,241
Robert Covington,PF,30,POR,26,26,816,69,186,0.371,44,132,0.33300000000000000,25,54,0.46300000000000000,0.489,16,18,0.889,20,140,160,47,42,24,27,68,198
Torrey Craig,SF,30,MIL,16,0,182,17,40,0.425,8,19,0.42100000000000000,9,21,0.429,0.525,1,2,0.5,12,27,39,12,9,5,5,23,43
Jae Crowder,PF,30,PHX,24,16,670,81,214,0.379,57,165,0.345,24,49,0.49,0.512,28,33,0.848,10,115,125,52,21,5,19,49,247
Jarrett Culver,SG,21,MIN,16,7,339,51,111,0.45900000000000000,8,31,0.258,43,80,0.5380000000000000,0.495,20,33,0.606,25,55,80,15,11,6,21,38,130
Seth Curry,SG,30,PHI,22,22,637,102,204,0.5,46,96,0.479,56,108,0.519,0.613,39,40,0.975,5,37,42,59,18,6,31,37,289
Stephen Curry,PG,32,GSW,29,29,987,290,590,0.49200000000000000,145,341,0.425,145,249,0.5820000000000000,0.614,144,154,0.935,13,142,155,175,35,2,93,54,869
Anthony Davis,PF,27,LAL,23,23,755,204,383,0.5330000000000000,17,58,0.293,187,325,0.575,0.555,93,130,0.715,47,146,193,70,31,41,45,42,518
Terence Davis,SG,23,TOR,23,2,305,56,129,0.434,28,74,0.37800000000000000,28,55,0.509,0.5430000000000000,9,10,0.9,6,30,36,21,12,3,19,38,149
DeMar DeRozan,PF,31,SAS,25,25,835,164,336,0.488,16,48,0.33300000000000000,148,288,0.514,0.512,151,169,0.893,19,106,125,172,19,8,41,44,495
Hamidou Diallo,SG,22,OKC,28,5,673,132,275,0.48,11,38,0.289,121,237,0.511,0.5,76,115,0.6610000000000000,32,119,151,69,29,10,42,71,351
Gorgui Dieng,C,31,MEM,19,1,336,50,94,0.532,20,40,0.5,30,54,0.556,0.638,26,31,0.8390000000000000,27,64,91,26,16,13,20,35,146
Spencer Dinwiddie,SG,27,BRK,3,3,64,6,16,0.375,2,7,0.28600000000000000,4,9,0.444,0.43800000000000000,6,6,1.0,0,13,13,9,2,1,5,4,20
Donte DiVincenzo,SG,24,MIL,29,29,759,110,263,0.418,57,143,0.39900000000000000,53,120,0.442,0.527,13,21,0.619,31,101,132,82,34,6,35,45,290
Luka Don?i?,PG,21,DAL,27,27,954,271,571,0.475,65,194,0.335,206,377,0.546,0.532,178,224,0.795,24,209,233,254,27,18,114,59,785
Luguentz Dort,SG,21,OKC,27,27,800,117,286,0.409,50,155,0.32300000000000000,67,131,0.511,0.49700000000000000,53,71,0.746,19,76,95,39,25,7,41,68,337
Damyean Dotson,SG,26,CLE,24,6,490,71,173,0.41,26,92,0.28300000000000000,45,81,0.556,0.486,18,26,0.6920000000000000,4,40,44,52,11,3,20,22,186
Sekou Doumbouya,PF,20,DET,24,1,314,36,102,0.353,10,39,0.256,26,63,0.413,0.402,17,23,0.7390000000000000,15,43,58,14,10,2,16,37,99
PJ Dozier,SG,24,DEN,17,0,330,44,94,0.46800000000000000,15,37,0.405,29,57,0.509,0.5480000000000000,18,25,0.72,16,54,70,23,9,10,13,29,121
Goran Dragi?,PG,34,MIA,17,6,451,89,195,0.456,28,78,0.359,61,117,0.521,0.528,38,47,0.809,7,45,52,90,9,2,51,45,244
Andre Drummond,C,27,CLE,25,25,722,180,380,0.474,0,8,0.0,180,372,0.484,0.474,77,129,0.597,101,236,337,64,40,29,81,69,437
Kevin Durant,PF,32,BRK,19,18,679,188,359,0.524,49,113,0.434,139,246,0.565,0.5920000000000000,126,145,0.8690000000000000,7,132,139,100,14,27,67,43,551
Anthony Edwards,SG,19,MIN,29,12,817,158,412,0.38300000000000000,53,166,0.319,105,246,0.42700000000000000,0.44800000000000000,54,67,0.8060000000000000,18,89,107,69,21,10,46,43,423
Carsen Edwards,SG,22,BOS,13,1,134,24,55,0.436,10,30,0.33300000000000000,14,25,0.56,0.527,7,9,0.778,2,11,13,5,4,1,2,16,65
CJ Elleby,SF,20,POR,12,0,96,14,29,0.483,5,18,0.278,9,11,0.818,0.569,6,9,0.667,4,8,12,3,3,3,3,16,39
Wayne Ellington,SG,33,DET,21,18,481,77,169,0.456,57,130,0.43800000000000000,20,39,0.513,0.624,12,16,0.75,7,34,41,24,8,4,14,32,223
Joel Embiid,C,26,PHI,23,23,748,217,402,0.54,27,68,0.397,190,334,0.569,0.573,222,261,0.851,44,204,248,71,30,28,79,58,683
James Ennis,SF,30,ORL,20,19,438,51,103,0.495,17,38,0.447,34,65,0.523,0.578,26,31,0.8390000000000000,23,52,75,27,19,6,20,44,145
Dante Exum,SG,25,CLE,6,3,116,10,26,0.385,2,11,0.182,8,15,0.5330000000000000,0.423,1,2,0.5,2,15,17,13,4,2,7,9,23
Derrick Favors,C,29,UTA,27,0,444,66,105,0.629,0,1,0.0,66,104,0.635,0.629,37,46,0.804,56,94,150,25,15,29,16,67,169
Bruno Fernando,C,22,ATL,15,0,132,9,22,0.409,0,2,0.0,9,20,0.45,0.409,9,15,0.6,12,40,52,9,2,2,12,15,27
Yogi Ferrell,PG,27,CLE,2,0,40,8,21,0.381,3,9,0.33300000000000000,5,12,0.41700000000000000,0.452,0,2,0.0,3,4,7,5,3,1,3,4,19
Dorian Finney-Smith,PF,27,DAL,19,19,583,63,140,0.45,37,97,0.381,26,43,0.605,0.5820000000000000,10,12,0.833,28,63,91,23,19,8,12,52,173
Malachi Flynn,PG,22,TOR,14,0,110,11,39,0.282,5,23,0.217,6,16,0.375,0.34600000000000000,2,4,0.5,1,8,9,16,4,0,4,11,29
Bryn Forbes,SG,27,MIL,29,6,543,101,210,0.48100000000000000,60,128,0.469,41,82,0.5,0.624,14,20,0.7,7,30,37,14,8,0,19,35,276
Evan Fournier,SF,28,ORL,15,15,430,87,193,0.451,34,93,0.366,53,100,0.53,0.539,60,75,0.8,4,34,38,54,15,6,31,34,268
De'Aaron Fox,PG,23,SAC,27,27,892,224,472,0.475,48,143,0.336,176,329,0.535,0.525,119,173,0.688,18,72,90,187,33,13,85,73,615
Markelle Fultz,PG,22,ORL,8,8,215,41,104,0.39400000000000000,4,16,0.25,37,88,0.42,0.413,17,19,0.895,5,20,25,43,8,2,18,18,103
Danilo Gallinari,PF,32,ATL,16,1,315,48,121,0.397,26,69,0.377,22,52,0.423,0.504,49,52,0.9420000000000000,3,43,46,18,3,2,19,31,171
Langston Galloway,SG,29,PHX,22,0,245,34,73,0.466,20,42,0.47600000000000000,14,31,0.452,0.603,16,16,1.0,4,20,24,15,4,0,7,13,104
Darius Garland,PG,21,CLE,21,18,679,135,299,0.452,35,86,0.40700000000000000,100,213,0.469,0.51,28,31,0.903,10,37,47,112,20,3,52,51,333
Marc Gasol,C,36,LAL,30,30,599,42,105,0.4,22,61,0.361,20,44,0.455,0.505,24,28,0.857,24,101,125,56,14,37,27,70,130
Rudy Gay,PF,34,SAS,26,0,572,108,258,0.419,41,112,0.366,67,146,0.45900000000000000,0.498,33,43,0.767,24,111,135,39,18,13,30,47,290
Paul George,SF,30,LAC,20,20,680,168,331,0.508,75,157,0.478,93,174,0.534,0.621,76,84,0.905,13,111,124,109,24,9,72,45,487
Taj Gibson,PF,35,NYK,8,0,109,10,20,0.5,1,5,0.2,9,15,0.6,0.525,3,6,0.5,11,14,25,4,2,3,2,15,24
Harry Giles,C,22,POR,22,0,260,26,62,0.419,3,8,0.375,23,54,0.426,0.444,13,18,0.722,25,83,108,20,5,9,16,44,68
Shai Gilgeous-Alexander,SG,22,OKC,22,22,741,173,344,0.503,41,107,0.38300000000000000,132,237,0.557,0.563,109,139,0.784,15,104,119,143,18,14,63,45,496
Anthony Gill,PF,28,WAS,10,1,65,3,10,0.3,1,7,0.14300000000000000,2,3,0.667,0.35,3,4,0.75,3,16,19,3,3,2,3,3,10
Rudy Gobert,C,28,UTA,29,29,878,158,247,0.64,0,1,0.0,158,246,0.642,0.64,97,167,0.581,102,288,390,37,12,78,47,65,413
Brandon Goodwin,PG,25,ATL,22,0,280,33,102,0.324,14,52,0.26900000000000000,19,50,0.38,0.392,17,24,0.708,3,24,27,43,10,0,12,23,97
Aaron Gordon,PF,25,ORL,19,19,552,91,213,0.42700000000000000,31,84,0.369,60,129,0.465,0.5,49,80,0.613,33,104,137,80,14,16,53,38,262
Eric Gordon,SG,32,HOU,22,10,646,137,296,0.46300000000000000,60,171,0.35100000000000000,77,125,0.616,0.564,78,92,0.848,7,42,49,60,12,11,42,32,412
Devonte' Graham,PG,25,CHA,25,25,821,109,310,0.35200000000000000,70,202,0.34700000000000000,39,108,0.361,0.465,55,71,0.775,14,61,75,142,25,0,35,38,343
Jerami Grant,SF,26,DET,28,28,1017,221,499,0.44300000000000000,72,186,0.387,149,313,0.47600000000000000,0.515,151,171,0.883,23,124,147,82,22,34,48,78,665
Danny Green,SF,33,PHI,29,29,824,89,222,0.401,63,168,0.375,26,54,0.48100000000000000,0.5430000000000000,10,14,0.7140000000000000,28,78,106,50,31,21,40,48,251
Draymond Green,PF,30,GSW,24,24,695,47,130,0.36200000000000000,8,43,0.18600000000000000,39,87,0.44800000000000000,0.392,23,34,0.6760000000000000,14,121,135,199,33,15,63,74,125
JaMychal Green,PF,30,DEN,24,3,511,79,179,0.441,41,96,0.42700000000000000,38,83,0.45800000000000000,0.556,27,32,0.8440000000000000,41,109,150,24,15,7,26,67,226
Javonte Green,SG,27,BOS,18,1,276,31,62,0.5,7,21,0.33300000000000000,24,41,0.585,0.556,20,29,0.69,17,28,45,8,17,2,11,22,89
Jeff Green,PF,34,BRK,31,14,813,106,210,0.505,48,113,0.425,58,97,0.598,0.619,37,45,0.8220000000000000,15,100,115,44,22,8,25,59,297
Josh Green,SG,20,DAL,17,5,212,17,36,0.47200000000000000,2,12,0.16700000000000000,15,24,0.625,0.5,6,11,0.545,12,27,39,10,4,1,11,16,42
Blake Griffin,PF,31,DET,20,20,626,81,222,0.365,39,124,0.315,42,98,0.429,0.45300000000000000,44,62,0.71,7,97,104,77,14,2,32,42,245
Kyle Guy,PG,23,SAC,11,0,88,9,35,0.257,4,19,0.21100000000000000,5,16,0.313,0.314,7,8,0.875,3,9,12,13,4,0,1,5,29
Rui Hachimura,PF,22,WAS,19,19,555,89,196,0.45400000000000000,15,50,0.3,74,146,0.507,0.49200000000000000,58,74,0.784,22,81,103,38,12,2,19,40,251
Tyrese Haliburton,PG,20,SAC,26,2,764,122,245,0.498,60,136,0.441,62,109,0.569,0.62,14,17,0.8240000000000000,26,66,92,135,31,15,42,34,318
Josh Hall,SF,20,OKC,7,0,51,4,18,0.222,1,8,0.125,3,10,0.3,0.25,3,7,0.429,1,8,9,7,0,0,4,7,12
R.J. Hampton,PG,19,DEN,21,0,180,19,47,0.40400000000000000,5,16,0.313,14,31,0.452,0.457,4,6,0.667,9,31,40,10,5,2,10,16,47
Tim Hardaway Jr.,SG,28,DAL,27,17,825,158,360,0.439,83,211,0.39300000000000000,75,149,0.503,0.5540000000000000,51,65,0.785,6,80,86,43,18,4,25,43,450
James Harden,SG,31,TOT,25,25,941,190,395,0.48100000000000000,76,197,0.386,114,198,0.5760000000000000,0.5770000000000000,154,172,0.895,18,162,180,282,27,19,104,56,610
James Harden,SG,31,HOU,8,8,290,60,135,0.444,25,72,0.34700000000000000,35,63,0.556,0.537,53,60,0.883,5,36,41,83,7,6,34,14,198
James Harden,SG,31,BRK,17,17,651,130,260,0.5,51,125,0.408,79,135,0.585,0.598,101,112,0.902,13,126,139,199,20,13,70,42,412
Maurice Harkless,SF,27,MIA,10,3,109,4,10,0.4,4,8,0.5,0,2,0.0,0.6,0,2,0.0,1,8,9,7,2,3,2,12,12
Montrezl Harrell,C,27,LAL,30,0,729,160,248,0.645,0,4,0.0,160,244,0.6560000000000000,0.645,76,103,0.738,67,119,186,32,20,21,37,65,396
Gary Harris,SG,26,DEN,19,19,581,69,156,0.442,24,75,0.32,45,81,0.556,0.519,22,30,0.733,13,34,47,32,17,4,14,37,184
Joe Harris,SF,29,BRK,31,27,959,173,324,0.534,104,205,0.507,69,119,0.58,0.6940000000000000,17,25,0.68,18,92,110,57,17,7,27,73,467
Tobias Harris,PF,28,PHI,26,26,896,207,400,0.518,46,108,0.426,161,292,0.551,0.575,81,90,0.9,33,168,201,81,21,22,53,55,541
Shaquille Harrison,SG,27,UTA,16,0,54,6,19,0.316,0,1,0.0,6,18,0.33300000000000000,0.316,5,6,0.833,3,6,9,8,2,0,5,3,17
Josh Hart,SF,25,NOP,28,2,785,88,195,0.451,40,115,0.348,48,80,0.6,0.5540000000000000,32,45,0.711,29,180,209,60,22,5,23,61,248
Killian Hayes,PG,19,DET,7,7,148,13,47,0.27700000000000000,5,20,0.25,8,27,0.29600000000000000,0.33,1,2,0.5,1,7,8,25,2,0,17,15,32
Gordon Hayward,SF,30,CHA,26,26,922,210,432,0.486,57,135,0.42200000000000000,153,297,0.515,0.552,102,118,0.8640000000000000,24,118,142,100,29,11,55,49,579
Juan Hernangómez,PF,25,MIN,13,6,242,30,75,0.4,14,44,0.318,16,31,0.516,0.493,9,14,0.643,13,52,65,7,5,2,6,12,83
Willy Hernangómez,C,26,NOP,13,0,222,36,66,0.545,1,5,0.2,35,61,0.574,0.5530000000000000,15,23,0.652,34,50,84,15,6,5,5,14,88
Tyler Herro,SG,21,MIA,21,14,720,141,312,0.452,44,128,0.344,97,184,0.527,0.522,40,52,0.769,9,121,130,81,10,10,55,36,366
Buddy Hield,SG,28,SAC,28,28,965,146,392,0.37200000000000000,107,289,0.37,39,103,0.379,0.509,41,47,0.872,10,120,130,84,25,10,55,76,440
George Hill,PG,34,OKC,14,14,369,61,120,0.508,22,57,0.386,39,63,0.619,0.6,21,25,0.84,8,21,29,43,12,2,12,12,165
Solomon Hill,PF,29,ATL,28,1,532,43,120,0.358,29,90,0.322,14,30,0.467,0.479,8,10,0.8,11,54,65,24,18,6,15,44,123
Nate Hinton,SG,21,DAL,6,0,19,3,13,0.231,1,5,0.2,2,8,0.25,0.26900000000000000,1,2,0.5,0,0,0,0,1,1,2,1,8
Aaron Holiday,PG,24,IND,29,6,576,81,219,0.37,31,93,0.33300000000000000,50,126,0.397,0.441,22,29,0.759,6,33,39,53,14,4,23,50,215
Jrue Holiday,PG,30,MIL,23,23,747,150,299,0.502,43,111,0.387,107,188,0.569,0.574,34,43,0.7910000000000000,29,81,110,124,44,14,36,40,377
Justin Holiday,SG,31,IND,29,20,935,115,247,0.466,70,167,0.419,45,80,0.563,0.607,34,43,0.7910000000000000,21,102,123,49,35,10,21,67,334
Richaun Holmes,C,27,SAC,25,25,739,136,210,0.648,1,5,0.2,135,205,0.659,0.65,46,58,0.7930000000000000,62,131,193,45,17,41,38,103,319
Rodney Hood,SF,28,POR,23,5,436,48,131,0.366,14,47,0.298,34,84,0.405,0.42,4,6,0.667,4,35,39,28,15,2,18,33,114
Al Horford,C,34,OKC,19,19,536,112,247,0.45300000000000000,41,105,0.39,71,142,0.5,0.536,14,18,0.778,16,115,131,69,18,16,24,33,279
Talen Horton-Tucker,SG,20,LAL,26,0,441,70,159,0.44,12,46,0.261,58,113,0.513,0.478,26,31,0.8390000000000000,9,53,62,49,21,13,32,50,178
Danuel House,SF,27,HOU,17,7,474,52,139,0.374,24,84,0.28600000000000000,28,55,0.509,0.46,23,30,0.767,10,52,62,36,13,9,16,31,151
Dwight Howard,C,35,PHI,29,4,483,61,110,0.555,3,8,0.375,58,102,0.569,0.568,45,86,0.523,78,145,223,19,12,25,54,91,170
Kevin Huerter,SG,22,ATL,28,17,890,127,300,0.423,62,161,0.385,65,139,0.46800000000000000,0.527,19,24,0.792,20,82,102,107,34,5,36,65,335
Elijah Hughes,SF,22,UTA,6,0,27,5,15,0.33300000000000000,3,10,0.3,2,5,0.4,0.433,3,4,0.75,0,4,4,3,1,1,4,0,16
De'Andre Hunter,SF,23,ATL,18,18,579,108,210,0.514,30,82,0.366,78,128,0.609,0.586,64,73,0.877,16,81,97,40,17,9,25,47,310
Chandler Hutchison,SF,24,CHI,7,0,64,5,18,0.278,1,3,0.33300000000000000,4,15,0.267,0.306,2,2,1.0,1,19,20,4,1,0,5,9,13
Serge Ibaka,C,31,LAC,29,29,701,138,268,0.515,29,77,0.377,109,191,0.5710000000000000,0.569,36,44,0.818,55,138,193,50,7,36,38,54,341
Andre Iguodala,SF,37,MIA,27,2,575,43,116,0.371,27,88,0.307,16,28,0.5710000000000000,0.48700000000000000,5,11,0.455,13,84,97,63,30,12,27,40,118
Joe Ingles,SF,33,UTA,25,8,665,102,197,0.518,60,133,0.451,42,64,0.6560000000000000,0.67,30,34,0.882,11,76,87,117,10,5,41,43,294
Brandon Ingram,SF,23,NOP,28,28,974,229,491,0.466,70,175,0.4,159,316,0.503,0.5380000000000000,132,151,0.8740000000000000,17,133,150,135,18,26,69,50,660
Kyrie Irving,PG,28,BRK,21,21,741,220,416,0.529,61,143,0.42700000000000000,159,273,0.5820000000000000,0.602,80,89,0.899,21,78,99,118,22,15,53,62,581
Wesley Iwundu,SF,26,DAL,17,3,232,13,46,0.28300000000000000,3,23,0.13,10,23,0.435,0.315,8,10,0.8,5,28,33,8,7,2,4,20,37
Josh Jackson,SG,23,DET,26,6,627,117,274,0.42700000000000000,37,115,0.322,80,159,0.503,0.495,61,89,0.685,19,85,104,50,25,24,62,78,332
Justin Jackson,SF,25,OKC,18,2,324,53,116,0.457,21,59,0.35600000000000000,32,57,0.561,0.547,14,18,0.778,8,35,43,33,7,1,18,21,141
Reggie Jackson,SG,30,LAC,27,14,562,85,199,0.42700000000000000,32,92,0.348,53,107,0.495,0.508,29,39,0.7440000000000000,9,63,72,88,18,3,25,51,231
Justin James,SF,24,SAC,9,0,55,8,18,0.444,1,6,0.16700000000000000,7,12,0.583,0.47200000000000000,2,8,0.25,2,5,7,5,2,1,0,1,19
LeBron James,PG,36,LAL,30,30,1039,288,567,0.508,74,199,0.37200000000000000,214,368,0.5820000000000000,0.573,126,179,0.7040000000000000,17,228,245,237,30,15,111,47,776
Isaiah Joe,SG,21,PHI,16,1,212,27,71,0.38,21,56,0.375,6,15,0.4,0.528,5,5,1.0,4,15,19,15,6,4,5,21,80
Cameron Johnson,PF,24,PHX,27,9,686,102,233,0.43800000000000000,59,160,0.369,43,73,0.589,0.564,27,31,0.871,17,81,98,40,17,8,21,36,290
James Johnson,PF,33,DAL,23,0,424,60,123,0.488,14,50,0.28,46,73,0.63,0.545,13,24,0.542,11,60,71,37,20,19,25,48,147
Keldon Johnson,SF,21,SAS,27,27,812,144,308,0.46800000000000000,26,80,0.325,118,228,0.518,0.51,77,99,0.778,47,141,188,61,21,14,40,62,391
Stanley Johnson,PF,24,TOR,26,1,370,26,63,0.413,16,38,0.42100000000000000,10,25,0.4,0.54,11,14,0.7860000000000000,14,49,63,36,21,8,18,43,79
Tyler Johnson,SG,28,BRK,14,1,167,22,52,0.423,16,36,0.444,6,16,0.375,0.5770000000000000,2,2,1.0,2,15,17,12,4,0,4,10,62
Nikola Joki?,C,25,DEN,28,28,1006,294,516,0.57,43,107,0.402,251,409,0.614,0.611,135,155,0.871,83,229,312,240,44,18,96,86,766
Damian Jones,C,25,PHX,11,0,78,4,10,0.4,0,1,0.0,4,9,0.444,0.4,5,9,0.556,7,9,16,0,1,5,5,18,13
Derrick Jones Jr.,SF,23,POR,24,23,650,68,143,0.47600000000000000,17,62,0.27400000000000000,51,81,0.63,0.535,30,49,0.612,44,69,113,17,20,22,16,62,183
Mason Jones,SG,22,HOU,18,1,201,33,72,0.45800000000000000,17,41,0.415,16,31,0.516,0.5760000000000000,17,31,0.5480000000000000,3,33,36,24,6,0,21,18,100
Tre Jones,PG,21,SAS,9,0,27,6,12,0.5,1,1,1.0,5,11,0.455,0.542,5,5,1.0,4,0,4,1,0,0,2,2,18
Tyus Jones,PG,24,MEM,24,8,565,78,192,0.406,17,68,0.25,61,124,0.49200000000000000,0.451,12,15,0.8,15,51,66,128,32,3,23,13,185
Cory Joseph,PG,29,SAC,28,1,559,76,162,0.469,20,58,0.345,56,104,0.5380000000000000,0.531,22,29,0.759,12,48,60,69,22,6,29,61,194
Mfiondu Kabengele,PF,23,LAC,17,0,69,6,23,0.261,2,12,0.16700000000000000,4,11,0.364,0.304,3,4,0.75,1,10,11,3,2,2,5,14,17
Frank Kaminsky,C,27,PHX,20,6,316,52,115,0.452,15,39,0.385,37,76,0.48700000000000000,0.517,14,23,0.609,19,70,89,40,4,10,10,32,133
Luke Kennard,SG,24,LAC,29,7,639,87,188,0.46300000000000000,46,104,0.442,41,84,0.488,0.585,13,15,0.867,8,75,83,52,10,6,27,47,233
Maxi Kleber,PF,29,DAL,17,11,435,37,86,0.43,29,64,0.45300000000000000,8,22,0.364,0.599,17,18,0.9440000000000000,16,75,91,25,6,13,10,40,120
Nathan Knight,PF,23,ATL,9,0,54,9,22,0.409,3,9,0.33300000000000000,6,13,0.462,0.47700000000000000,7,8,0.875,8,6,14,1,2,3,4,7,28
Kevin Knox,SF,21,NYK,23,0,373,44,113,0.389,25,66,0.379,19,47,0.40400000000000000,0.5,10,12,0.833,9,39,48,17,8,6,16,33,123
John Konchar,SG,24,MEM,16,0,264,24,56,0.429,7,22,0.318,17,34,0.5,0.491,15,16,0.938,16,45,61,18,18,5,8,23,70
Furkan Korkmaz,SG,23,PHI,18,1,351,49,130,0.377,24,75,0.32,25,55,0.455,0.469,14,16,0.875,4,42,46,14,13,2,17,20,136
Luke Kornet,PF,25,CHI,6,0,43,3,14,0.214,1,11,0.091,2,3,0.667,0.25,2,2,1.0,0,9,9,2,2,1,1,1,9
Rodions Kurucs,SF-PF,22,TOT,14,0,73,6,20,0.3,3,14,0.214,3,6,0.5,0.375,1,2,0.5,2,10,12,4,5,2,7,8,16
Rodions Kurucs,SF,22,HOU,9,0,57,5,17,0.294,2,12,0.16700000000000000,3,5,0.6,0.353,1,2,0.5,2,7,9,2,5,2,7,7,13
Kyle Kuzma,SF,25,LAL,30,8,758,132,289,0.457,50,138,0.36200000000000000,82,151,0.5430000000000000,0.5430000000000000,16,26,0.615,56,128,184,33,10,20,40,45,330
Jeremy Lamb,SG,28,IND,16,8,401,66,130,0.508,31,62,0.5,35,68,0.515,0.627,36,39,0.9230000000000000,15,55,70,26,14,8,14,33,199
Zach LaVine,SG,25,CHI,27,27,962,275,529,0.52,97,222,0.43700000000000000,178,307,0.58,0.612,122,144,0.847,22,127,149,140,30,12,104,71,769
Jake Layman,SF,26,MIN,19,3,292,45,92,0.489,11,37,0.297,34,55,0.618,0.5490000000000000,18,23,0.7830000000000000,5,23,28,10,17,9,10,23,119
Jalen Lecque,PG,20,IND,3,0,9,1,4,0.25,0,1,0.0,1,3,0.33300000000000000,0.25,3,3,1.0,1,3,4,2,0,0,0,0,5
Damion Lee,SG,28,GSW,29,0,561,60,139,0.43200000000000000,41,110,0.373,19,29,0.655,0.579,20,22,0.909,12,86,98,44,17,3,13,48,181
Saben Lee,PG,21,DET,8,0,70,5,14,0.35700000000000000,0,1,0.0,5,13,0.385,0.35700000000000000,8,10,0.8,1,2,3,8,4,1,5,9,18
Alex Len,C,27,TOT,20,6,292,47,75,0.627,6,19,0.316,41,56,0.732,0.667,20,34,0.588,14,55,69,21,8,22,22,38,120
Alex Len,C,27,TOR,7,2,76,5,10,0.5,3,6,0.5,2,4,0.5,0.65,3,6,0.5,0,11,11,3,1,6,8,10,16
Alex Len,C,27,WAS,13,4,216,42,65,0.6460000000000000,3,13,0.231,39,52,0.75,0.669,17,28,0.607,14,44,58,18,7,16,14,28,104
Kawhi Leonard,SF,29,LAC,23,23,792,224,437,0.513,44,113,0.389,180,324,0.556,0.563,123,140,0.879,19,116,135,115,41,14,42,34,615
Caris LeVert,SG,26,BRK,12,4,334,87,200,0.435,22,63,0.349,65,137,0.474,0.49,26,34,0.765,10,42,52,72,13,6,26,20,222
Kira Lewis Jr.,PG,19,NOP,17,0,223,35,87,0.402,11,29,0.379,24,58,0.414,0.466,13,20,0.65,2,13,15,30,10,1,8,17,94
Damian Lillard,PG,30,POR,27,27,969,249,552,0.451,112,292,0.384,137,260,0.527,0.5530000000000000,195,209,0.9330000000000000,13,106,119,209,29,7,85,44,805
Nassir Little,PF,20,POR,13,2,141,22,40,0.55,11,18,0.611,11,22,0.5,0.688,8,9,0.889,10,16,26,3,2,4,7,11,63
Kevon Looney,C,24,GSW,21,5,308,33,53,0.623,2,5,0.4,31,48,0.6460000000000000,0.642,9,13,0.6920000000000000,32,55,87,37,7,6,14,37,77
Brook Lopez,C,32,MIL,29,29,781,113,244,0.46300000000000000,47,131,0.359,66,113,0.584,0.5590000000000000,40,47,0.851,44,102,146,17,14,39,23,55,313
Robin Lopez,C,32,WAS,26,9,505,81,137,0.591,4,12,0.33300000000000000,77,125,0.616,0.606,41,61,0.672,57,52,109,25,6,14,26,50,207
Kevin Love,PF,32,CLE,2,2,46,6,18,0.33300000000000000,3,9,0.33300000000000000,3,9,0.33300000000000000,0.41700000000000000,4,5,0.8,2,10,12,5,1,0,3,1,19
Kyle Lowry,PG,34,TOR,25,25,859,149,330,0.452,69,178,0.38800000000000000,80,152,0.526,0.556,76,87,0.8740000000000000,19,116,135,161,29,4,72,79,443
Timothé Luwawu-Cabarrot,SF,25,BRK,31,5,617,83,202,0.41100000000000000,50,131,0.382,33,71,0.465,0.535,18,24,0.75,17,57,74,41,21,5,23,54,234
Trey Lyles,PF,25,SAS,14,2,165,18,36,0.5,4,15,0.267,14,21,0.667,0.556,9,15,0.6,7,36,43,7,0,0,0,5,49
Thon Maker,C,23,CLE,8,0,76,10,18,0.556,0,2,0.0,10,16,0.625,0.556,10,11,0.909,8,10,18,4,2,4,3,7,30
Théo Maledon,PG,19,OKC,23,8,538,64,160,0.4,34,90,0.37800000000000000,30,70,0.429,0.506,17,24,0.708,5,57,62,65,23,1,41,50,179
Karim Mané,PG,20,ORL,6,0,56,1,9,0.111,1,2,0.5,0,7,0.0,0.16700000000000000,4,4,1.0,0,10,10,1,0,1,3,3,7
Terance Mann,SG,24,LAC,27,3,407,43,94,0.457,6,24,0.25,37,70,0.529,0.489,24,32,0.75,25,65,90,31,13,5,18,40,116
Nico Mannion,PG,19,GSW,6,0,36,3,13,0.231,2,9,0.222,1,4,0.25,0.308,1,4,0.25,0,8,8,12,2,0,2,5,9
Boban Marjanovi?,C,32,DAL,15,0,108,28,54,0.519,0,3,0.0,28,51,0.5490000000000000,0.519,9,13,0.6920000000000000,20,30,50,1,0,0,3,12,65
Lauri Markkanen,PF,23,CHI,14,14,426,95,185,0.514,40,101,0.396,55,84,0.655,0.622,38,45,0.8440000000000000,8,77,85,12,9,5,24,31,268
Naji Marshall,SF,23,NOP,3,0,8,0,2,0.0,0,1,0.0,0,1,0.0,0.0,1,2,0.5,0,2,2,1,0,0,0,0,1
Caleb Martin,SF,25,CHA,23,1,363,50,119,0.42,15,50,0.3,35,69,0.507,0.483,14,25,0.56,19,45,64,29,20,7,16,25,129
Cody Martin,SF,25,CHA,17,0,159,20,38,0.526,3,13,0.231,17,25,0.68,0.5660000000000000,8,10,0.8,10,24,34,16,7,0,9,9,51
Kenyon Martin Jr.,SF,20,HOU,7,0,69,10,27,0.37,1,4,0.25,9,23,0.391,0.389,2,5,0.4,8,11,19,4,2,5,5,9,23
Frank Mason III,PG,26,ORL,4,1,79,9,24,0.375,2,5,0.4,7,19,0.368,0.41700000000000000,5,7,0.7140000000000000,3,9,12,12,0,0,5,7,25
Garrison Mathews,SG,24,WAS,20,4,322,37,95,0.389,29,76,0.382,8,19,0.42100000000000000,0.542,37,41,0.902,8,22,30,10,18,4,3,32,140
Dakota Mathias,SG,25,PHI,8,2,123,19,48,0.396,8,26,0.308,11,22,0.5,0.479,2,6,0.33300000000000000,1,6,7,13,1,3,1,7,48
Wesley Matthews,SG,34,LAL,23,2,473,37,94,0.39400000000000000,28,75,0.373,9,19,0.474,0.5430000000000000,12,15,0.8,9,23,32,26,10,8,9,34,114
Tyrese Maxey,SG,20,PHI,28,6,472,103,226,0.456,15,54,0.278,88,172,0.512,0.489,22,25,0.88,6,47,53,48,15,3,18,33,243
Skylar Mays,SG,23,ATL,10,0,68,12,27,0.444,5,12,0.41700000000000000,7,15,0.467,0.537,9,10,0.9,3,5,8,7,2,0,1,3,38
CJ McCollum,SG,29,POR,13,13,440,123,260,0.473,63,143,0.441,60,117,0.513,0.594,38,45,0.8440000000000000,7,44,51,65,17,4,13,28,347
T.J. McConnell,PG,28,IND,26,1,623,70,139,0.504,6,16,0.375,64,123,0.52,0.525,4,12,0.33300000000000000,18,69,87,172,45,10,45,41,150
Jaden McDaniels,PF,20,MIN,23,1,431,47,118,0.39800000000000000,24,63,0.381,23,55,0.418,0.5,6,15,0.4,15,62,77,23,8,25,19,58,124
Jalen McDaniels,SF,23,CHA,10,0,108,16,33,0.485,2,9,0.222,14,24,0.583,0.515,7,11,0.636,4,17,21,6,2,0,9,15,41
Doug McDermott,PF,29,IND,28,8,733,144,282,0.511,43,121,0.355,101,161,0.627,0.5870000000000000,35,44,0.795,28,86,114,38,7,2,30,50,366
Sean McDermott,SF,24,MEM,6,0,92,7,15,0.467,4,11,0.364,3,4,0.75,0.6,4,4,1.0,3,5,8,3,1,1,3,4,22
JaVale McGee,C,33,CLE,20,1,313,62,135,0.45900000000000000,5,16,0.313,57,119,0.479,0.478,26,44,0.591,34,78,112,20,9,24,25,49,155
Rodney McGruder,SG,29,DET,8,0,64,9,19,0.474,3,7,0.429,6,12,0.5,0.5530000000000000,3,3,1.0,3,6,9,6,0,1,4,4,24
Alfonzo McKinnie,SF,28,LAL,15,0,49,11,17,0.647,4,6,0.667,7,11,0.636,0.765,2,4,0.5,6,10,16,1,1,0,1,4,28
Jordan McLaughlin,PG,24,MIN,17,0,310,37,94,0.39400000000000000,9,24,0.375,28,70,0.4,0.441,7,9,0.778,9,29,38,79,17,3,20,13,90
Ben McLemore,SG,27,HOU,20,2,303,43,115,0.374,28,83,0.337,15,32,0.469,0.496,13,18,0.722,7,36,43,19,12,1,21,26,127
Nicolò Melli,PF,30,NOP,13,0,137,8,28,0.28600000000000000,6,22,0.273,2,6,0.33300000000000000,0.39300000000000000,4,5,0.8,2,25,27,12,6,1,6,16,26
De'Anthony Melton,PG,22,MEM,12,0,258,48,100,0.48,19,43,0.442,29,57,0.509,0.575,5,8,0.625,4,32,36,38,11,12,17,25,120
Sam Merrill,SG,24,MIL,9,0,55,4,10,0.4,4,8,0.5,0,2,0.0,0.6,2,2,1.0,3,7,10,10,1,0,3,3,14
Chimezie Metu,C,23,SAC,11,0,71,15,30,0.5,1,3,0.33300000000000000,14,27,0.519,0.517,6,9,0.667,11,12,23,5,3,6,6,10,37
Khris Middleton,SF,29,MIL,29,29,961,214,423,0.506,68,157,0.433,146,266,0.5490000000000000,0.586,86,95,0.905,22,149,171,168,30,4,77,81,582
Darius Miller,SF,30,OKC,12,0,111,11,24,0.45800000000000000,9,21,0.429,2,3,0.667,0.6460000000000000,3,3,1.0,1,14,15,10,5,4,5,9,34
Patty Mills,PG,32,SAS,27,0,687,127,283,0.449,70,175,0.4,57,108,0.528,0.5720000000000000,33,35,0.943,7,44,51,73,18,1,26,39,357
Paul Millsap,PF,35,DEN,26,26,621,99,189,0.524,32,78,0.41,67,111,0.604,0.608,41,59,0.695,41,93,134,43,22,14,26,54,271
Shake Milton,SG,24,PHI,22,1,536,108,239,0.452,22,72,0.306,86,167,0.515,0.498,70,80,0.875,12,30,42,66,16,4,34,49,308
Donovan Mitchell,SG,24,UTA,27,27,908,224,524,0.42700000000000000,91,233,0.391,133,291,0.457,0.514,114,137,0.8320000000000000,27,92,119,139,23,10,80,60,653
Malik Monk,SG,22,CHA,15,0,316,54,120,0.45,33,66,0.5,21,54,0.389,0.588,17,20,0.85,5,30,35,27,4,2,17,19,158
E'Twaun Moore,SG,31,PHX,14,1,227,32,73,0.43800000000000000,5,19,0.263,27,54,0.5,0.473,6,8,0.75,5,15,20,22,11,1,13,22,75
Ja Morant,PG,21,MEM,16,16,484,109,238,0.45800000000000000,13,52,0.25,96,186,0.516,0.485,69,86,0.802,12,37,49,132,14,4,51,23,300
Juwan Morgan,PF,23,UTA,12,0,64,6,13,0.462,3,9,0.33300000000000000,3,4,0.75,0.5770000000000000,0,3,0.0,3,10,13,3,3,0,2,11,15
Marcus Morris,PF,31,LAC,21,2,524,95,211,0.45,53,106,0.5,42,105,0.4,0.5760000000000000,35,39,0.897,17,64,81,18,12,6,21,38,278
Markieff Morris,PF,31,LAL,24,2,363,36,95,0.379,20,63,0.317,16,32,0.5,0.484,13,18,0.722,14,67,81,20,4,6,12,37,105
Monte Morris,PG,25,DEN,27,3,701,112,229,0.489,34,87,0.391,78,142,0.5490000000000000,0.563,33,47,0.7020000000000000,7,50,57,90,18,7,17,22,291
Mychal Mulder,PG,26,GSW,28,1,303,40,84,0.47600000000000000,32,72,0.444,8,12,0.667,0.667,7,11,0.636,1,25,26,12,6,6,5,27,119
Dejounte Murray,PG,24,SAS,27,27,821,167,374,0.447,28,89,0.315,139,285,0.488,0.484,47,58,0.81,17,177,194,136,42,2,45,58,409
Jamal Murray,PG,23,DEN,26,26,908,187,414,0.452,59,165,0.358,128,249,0.514,0.523,72,89,0.809,19,93,112,118,29,7,59,55,505
Mike Muscala,C,29,OKC,26,0,495,88,198,0.444,52,137,0.38,36,61,0.59,0.5760000000000000,29,32,0.9060000000000000,14,82,96,23,7,7,17,40,257
Sviatoslav Mykhailiuk,SF,23,DET,27,0,417,57,150,0.38,37,115,0.322,20,35,0.5710000000000000,0.503,21,24,0.875,7,43,50,33,17,5,18,23,172
Abdel Nader,SF,27,PHX,12,0,172,31,62,0.5,10,25,0.4,21,37,0.568,0.581,14,18,0.778,0,29,29,11,5,1,8,13,86
Larry Nance Jr.,PF,28,CLE,19,18,635,70,145,0.483,24,63,0.381,46,82,0.561,0.5660000000000000,12,21,0.5710000000000000,27,102,129,61,37,10,28,41,176
Aaron Nesmith,SF,21,BOS,13,0,191,16,47,0.34,12,38,0.316,4,9,0.444,0.46800000000000000,5,7,0.7140000000000000,7,23,30,7,0,4,9,24,49
Raul Neto,PG,28,WAS,21,6,396,66,141,0.46800000000000000,21,57,0.368,45,84,0.536,0.5430000000000000,16,20,0.8,10,37,47,35,21,2,13,27,169
Georges Niang,PF,27,UTA,29,0,381,53,136,0.39,30,93,0.32300000000000000,23,43,0.535,0.5,5,5,1.0,10,54,64,22,11,3,19,44,141
Zeke Nnaji,PF,20,DEN,15,0,112,16,32,0.5,10,20,0.5,6,12,0.5,0.6560000000000000,2,4,0.5,5,8,13,0,1,1,0,7,44
Nerlens Noel,C,26,NYK,25,3,475,44,78,0.564,0,2,0.0,44,76,0.579,0.564,12,22,0.545,42,91,133,12,23,48,23,56,100
Jaylen Nowell,SG,21,MIN,15,0,236,53,116,0.457,17,48,0.354,36,68,0.529,0.53,22,28,0.7860000000000000,8,18,26,14,6,4,9,27,145
Frank Ntilikina,PG,22,NYK,4,0,42,6,14,0.429,5,9,0.556,1,5,0.2,0.607,1,3,0.33300000000000000,1,3,4,3,3,0,2,7,18
Kendrick Nunn,PG,25,MIA,21,9,599,113,240,0.47100000000000000,42,117,0.359,71,123,0.5770000000000000,0.5580000000000000,21,24,0.875,9,58,67,47,23,4,42,39,289
Jusuf Nurki?,C,26,POR,12,12,280,50,103,0.485,3,12,0.25,47,91,0.516,0.5,15,27,0.556,23,69,92,33,11,11,23,33,118
David Nwaba,SF,28,HOU,24,9,560,81,168,0.48200000000000000,14,53,0.264,67,115,0.583,0.524,34,50,0.68,29,59,88,26,26,18,15,50,210
Jordan Nwora,SF,22,MIL,10,0,82,17,37,0.45900000000000000,8,16,0.5,9,21,0.429,0.568,9,10,0.9,1,14,15,0,4,2,10,9,51
Royce O'Neale,SF,27,UTA,29,29,944,78,169,0.462,51,119,0.429,27,50,0.54,0.612,22,26,0.846,33,166,199,66,23,19,33,84,229
Semi Ojeleye,PF,26,BOS,27,6,530,53,128,0.414,34,90,0.37800000000000000,19,38,0.5,0.547,18,25,0.72,17,68,85,23,8,0,12,33,158
Jahlil Okafor,C,25,DET,12,0,120,25,42,0.595,0,3,0.0,25,39,0.6410000000000000,0.595,1,2,0.5,13,14,27,3,2,2,4,10,51
Chuma Okeke,PF,22,ORL,13,0,282,22,58,0.379,9,29,0.31,13,29,0.44800000000000000,0.457,3,6,0.5,16,28,44,27,11,4,9,13,56
Josh Okogie,SG,22,MIN,23,18,467,38,110,0.345,10,46,0.217,28,64,0.43800000000000000,0.391,29,38,0.763,22,37,59,27,19,14,17,43,115
Isaac Okoro,SG,20,CLE,24,24,792,66,170,0.38800000000000000,16,64,0.25,50,106,0.47200000000000000,0.435,31,46,0.674,21,36,57,45,27,10,33,69,179
KZ Okpala,PF,21,MIA,15,5,169,12,31,0.387,7,19,0.368,5,12,0.41700000000000000,0.5,2,6,0.33300000000000000,4,16,20,6,3,2,8,19,33
Victor Oladipo,SG,28,TOT,20,20,640,140,349,0.401,48,146,0.32900000000000000,92,203,0.45300000000000000,0.47,54,73,0.74,4,100,104,92,27,8,44,48,382
Victor Oladipo,SG,28,IND,9,9,300,64,152,0.42100000000000000,25,69,0.36200000000000000,39,83,0.47,0.503,27,37,0.73,1,50,51,38,15,2,18,23,180
Victor Oladipo,SG,28,HOU,11,11,340,76,197,0.386,23,77,0.299,53,120,0.442,0.444,27,36,0.75,3,50,53,54,12,6,26,25,202
Kelly Olynyk,C,29,MIA,28,23,727,107,245,0.43700000000000000,58,173,0.335,49,72,0.6810000000000000,0.555,16,22,0.727,28,135,163,56,22,18,36,71,288
Miye Oni,SG,23,UTA,23,0,185,10,31,0.32300000000000000,9,26,0.34600000000000000,1,5,0.2,0.46800000000000000,5,6,0.833,12,29,41,6,3,4,7,26,34
Cedi Osman,SF,25,CLE,29,13,766,120,315,0.381,60,176,0.341,60,139,0.43200000000000000,0.47600000000000000,33,42,0.7860000000000000,20,77,97,74,25,3,30,61,333
Daniel Oturu,C,21,LAC,10,0,42,9,15,0.6,0,1,0.0,9,14,0.643,0.6,2,2,1.0,5,9,14,4,0,3,2,6,20
Kelly Oubre Jr.,SF,25,GSW,29,29,853,151,368,0.41,48,155,0.31,103,213,0.484,0.47600000000000000,63,83,0.759,41,130,171,41,32,23,40,69,413
Eric Paschall,PF,24,GSW,26,2,459,102,201,0.507,12,36,0.33300000000000000,90,165,0.545,0.537,45,63,0.7140000000000000,23,65,88,33,5,3,20,44,261
Patrick Patterson,PF,31,LAC,10,1,130,16,38,0.42100000000000000,10,28,0.35700000000000000,6,10,0.6,0.5530000000000000,3,4,0.75,4,16,20,5,3,1,7,13,45
Chris Paul,PG,35,PHX,26,26,843,170,348,0.489,38,103,0.369,132,245,0.539,0.5430000000000000,69,71,0.972,15,107,122,213,32,7,61,71,447
Cameron Payne,PG,26,PHX,16,0,275,41,89,0.461,15,38,0.395,26,51,0.51,0.545,9,9,1.0,2,28,30,58,9,3,19,33,106
Elfrid Payton,PG,26,NYK,30,30,831,156,354,0.441,14,56,0.25,142,298,0.47700000000000000,0.46,41,57,0.7190000000000000,38,77,115,107,19,6,57,59,367
Reggie Perry,PF,20,BRK,14,0,147,21,51,0.41200000000000000,2,12,0.16700000000000000,19,39,0.48700000000000000,0.431,6,9,0.667,17,34,51,12,2,5,11,27,50
Mason Plumlee,C,30,DET,26,26,726,109,183,0.596,0,5,0.0,109,178,0.612,0.596,47,68,0.691,79,151,230,89,24,17,53,92,265
Jordan Poole,SG,21,GSW,15,0,143,26,61,0.426,13,39,0.33300000000000000,13,22,0.591,0.5330000000000000,18,19,0.9470000000000000,2,16,18,13,3,2,8,14,83
Michael Porter Jr.,SF,22,DEN,18,11,486,92,194,0.474,38,102,0.373,54,92,0.5870000000000000,0.5720000000000000,24,30,0.8,21,89,110,19,18,21,19,41,246
Otto Porter,SF,27,CHI,16,6,372,64,144,0.444,28,70,0.4,36,74,0.486,0.542,30,36,0.833,20,80,100,32,9,3,15,25,186
Bobby Portis,C,25,MIL,29,1,629,141,255,0.5530000000000000,30,62,0.484,111,193,0.575,0.612,19,28,0.679,58,153,211,33,25,11,23,57,331
Kristaps Porzi??is,C,25,DAL,17,17,509,132,279,0.473,38,108,0.35200000000000000,94,171,0.55,0.541,47,55,0.855,35,105,140,22,6,27,21,56,349
Dwight Powell,C,29,DAL,17,6,277,24,47,0.511,1,7,0.14300000000000000,23,40,0.575,0.521,31,45,0.6890000000000000,20,41,61,16,13,6,11,41,80
Norman Powell,SG,27,TOR,27,16,766,152,320,0.475,63,146,0.43200000000000000,89,174,0.511,0.573,85,97,0.8760000000000000,11,68,79,41,30,4,38,56,452
Taurean Prince,PF,26,TOT,27,10,592,76,194,0.392,38,95,0.4,38,99,0.384,0.49,45,53,0.8490000000000000,12,86,98,46,19,19,31,50,235
Taurean Prince,PF,26,BRK,12,4,218,30,74,0.405,13,37,0.35100000000000000,17,37,0.45900000000000000,0.493,24,27,0.889,2,32,34,7,8,8,11,21,97
Taurean Prince,PF,26,CLE,15,6,374,46,120,0.38300000000000000,25,58,0.431,21,62,0.33900000000000000,0.488,21,26,0.8080000000000000,10,54,64,39,11,11,20,29,138
Payton Pritchard,SG,23,BOS,22,1,472,66,139,0.475,32,78,0.41,34,61,0.557,0.59,12,13,0.9230000000000000,11,43,54,53,13,5,28,44,176
Immanuel Quickley,PG,21,NYK,26,0,505,101,256,0.395,44,120,0.36700000000000000,57,136,0.419,0.48,76,80,0.95,10,51,61,69,11,9,24,54,322
Julius Randle,PF,26,NYK,30,30,1101,243,506,0.48,55,135,0.40700000000000000,188,371,0.507,0.535,154,192,0.802,41,285,326,166,22,6,98,93,695
Cam Reddish,SF,21,ATL,24,19,692,91,242,0.376,31,117,0.265,60,125,0.48,0.44,62,77,0.805,19,76,95,34,27,8,32,64,275
J.J. Redick,SG,36,NOP,25,0,456,63,167,0.377,43,117,0.368,20,50,0.4,0.506,35,36,0.972,3,35,38,28,8,2,20,30,204
Naz Reid,C,21,MIN,27,13,581,131,250,0.524,29,73,0.397,102,177,0.5760000000000000,0.5820000000000000,46,63,0.73,36,96,132,36,18,33,31,84,337
Josh Richardson,SG,27,DAL,19,19,601,83,196,0.423,29,98,0.29600000000000000,54,98,0.551,0.49700000000000000,42,45,0.9330000000000000,19,36,55,51,16,4,26,56,237
Austin Rivers,SG,28,NYK,21,2,442,58,135,0.43,28,77,0.364,30,58,0.517,0.5330000000000000,10,14,0.7140000000000000,5,42,47,42,12,0,22,32,154
Duncan Robinson,SF,26,MIA,29,29,964,120,285,0.42100000000000000,96,245,0.392,24,40,0.6,0.589,36,42,0.857,1,107,108,46,13,7,42,66,372
Glenn Robinson III,SF,27,SAC,23,2,369,42,99,0.424,16,44,0.364,26,55,0.473,0.505,21,23,0.9130000000000000,11,34,45,20,4,3,11,23,121
Jerome Robinson,SG,23,WAS,13,3,221,22,67,0.32800000000000000,9,31,0.29,13,36,0.361,0.396,15,17,0.882,2,31,33,18,6,2,11,21,68
Isaiah Roby,PF,22,OKC,22,9,445,74,137,0.54,11,35,0.314,63,102,0.618,0.58,29,42,0.69,36,78,114,34,15,14,23,56,188
Rajon Rondo,PG,34,ATL,14,2,214,19,55,0.345,8,26,0.308,11,29,0.379,0.418,1,2,0.5,4,28,32,54,9,1,19,13,47
Derrick Rose,PG,32,TOT,20,0,445,100,234,0.42700000000000000,16,48,0.33300000000000000,84,186,0.452,0.462,53,63,0.841,7,36,43,80,23,7,37,21,269
Derrick Rose,PG,32,DET,15,0,342,79,184,0.429,13,39,0.33300000000000000,66,145,0.455,0.465,42,50,0.84,6,23,29,63,18,4,29,17,213
Derrick Rose,PG,32,NYK,5,0,103,21,50,0.42,3,9,0.33300000000000000,18,41,0.439,0.45,11,13,0.846,1,13,14,17,5,3,8,4,56
Terrence Ross,SG,29,ORL,28,1,806,154,372,0.414,55,159,0.34600000000000000,99,213,0.465,0.488,66,74,0.892,8,82,90,60,27,15,51,56,429
Terry Rozier,SG,26,CHA,26,26,867,194,396,0.49,89,200,0.445,105,196,0.536,0.602,58,73,0.795,15,91,106,79,33,12,45,51,535
Ricky Rubio,PG,30,MIN,27,12,679,67,181,0.37,16,58,0.276,51,123,0.415,0.414,44,53,0.83,11,80,91,176,34,0,56,60,194
D'Angelo Russell,PG,24,MIN,20,19,583,139,326,0.426,59,148,0.39900000000000000,80,178,0.449,0.517,48,64,0.75,9,43,52,101,22,10,54,39,385
Domantas Sabonis,PF,24,IND,29,29,1055,237,449,0.528,29,81,0.358,208,368,0.565,0.56,120,169,0.71,80,256,336,166,29,19,98,103,623
Luka amani?,PF,21,SAS,4,0,11,2,6,0.33300000000000000,2,3,0.667,0,3,0.0,0.5,1,2,0.5,0,0,0,0,0,0,0,0,7
JaKarr Sampson,PF,27,IND,13,0,78,11,25,0.44,0,3,0.0,11,22,0.5,0.44,8,10,0.8,7,19,26,0,1,3,3,9,30
Dario ari?,PF,26,PHX,10,0,181,35,80,0.43800000000000000,11,35,0.314,24,45,0.5330000000000000,0.506,23,24,0.958,7,33,40,12,10,2,14,20,104
Tomá Satoranský,SG,29,CHI,16,0,320,36,73,0.493,11,25,0.44,25,48,0.521,0.568,19,21,0.905,5,38,43,78,10,3,24,21,102
Dennis Schröder,SG,27,LAL,29,29,902,147,333,0.441,28,90,0.311,119,243,0.49,0.483,91,111,0.82,17,88,105,125,27,6,65,77,413
Mike Scott,PF,32,PHI,11,3,193,16,48,0.33300000000000000,11,38,0.289,5,10,0.5,0.44800000000000000,2,3,0.667,4,25,29,1,3,2,5,15,45
Collin Sexton,SG,22,CLE,24,24,847,202,417,0.484,35,86,0.40700000000000000,167,331,0.505,0.526,107,133,0.805,18,43,61,102,26,4,59,70,546
Landry Shamet,SG,23,BRK,27,0,513,64,168,0.381,43,121,0.355,21,47,0.447,0.509,31,35,0.8860000000000000,5,37,42,35,13,4,22,34,202
Pascal Siakam,PF,26,TOR,26,26,933,200,438,0.457,33,108,0.306,167,330,0.506,0.494,109,135,0.807,55,145,200,118,30,17,57,79,542
Chris Silva,PF,24,MIA,6,0,53,6,9,0.667,1,1,1.0,5,8,0.625,0.722,10,12,0.833,7,11,18,6,1,2,8,14,23
Ben Simmons,PG,24,PHI,25,25,835,146,260,0.562,1,6,0.16700000000000000,145,254,0.5710000000000000,0.563,88,132,0.667,40,167,207,201,42,20,84,80,381
Anfernee Simons,SG,21,POR,25,0,447,76,184,0.413,55,131,0.42,21,53,0.396,0.563,19,23,0.826,6,52,58,31,6,5,21,42,226
Marcus Smart,PG,26,BOS,17,17,549,74,188,0.39400000000000000,28,90,0.311,46,98,0.469,0.46800000000000000,46,62,0.742,7,40,47,103,31,9,30,39,222
Dennis Smith Jr.,PG,23,TOT,7,0,85,11,33,0.33300000000000000,2,12,0.16700000000000000,9,21,0.429,0.364,8,10,0.8,2,6,8,11,3,1,5,5,32
Dennis Smith Jr.,PG,23,NYK,3,0,28,2,10,0.2,0,4,0.0,2,6,0.33300000000000000,0.2,5,6,0.833,0,2,2,3,3,0,1,4,9
Dennis Smith Jr.,PG,23,DET,4,0,57,9,23,0.391,2,8,0.25,7,15,0.467,0.435,3,4,0.75,2,4,6,8,0,1,4,1,23
Ish Smith,PG,32,WAS,19,1,391,44,116,0.379,5,20,0.25,39,96,0.406,0.401,6,15,0.4,10,56,66,90,15,4,19,18,99
Jalen Smith,PF,20,PHX,8,0,50,6,17,0.353,2,7,0.28600000000000000,4,10,0.4,0.41200000000000000,0,2,0.0,5,5,10,2,0,2,1,3,14
Ray Spalding,C,23,HOU,2,0,19,2,4,0.5,0,1,0.0,2,3,0.667,0.5,0,2,0.0,2,2,4,0,0,2,3,3,4
Cassius Stanley,SG,21,IND,8,0,23,2,7,0.28600000000000000,1,2,0.5,1,5,0.2,0.35700000000000000,4,5,0.8,2,1,3,0,0,2,1,7,9
Lamar Stevens,PF,23,CLE,18,0,265,31,77,0.40300000000000000,2,15,0.133,29,62,0.46800000000000000,0.41600000000000000,18,27,0.667,7,39,46,19,8,5,8,22,82
Isaiah Stewart,C,19,DET,26,2,466,57,109,0.523,1,4,0.25,56,105,0.5330000000000000,0.528,21,30,0.7,64,76,140,17,13,24,20,71,136
Max Strus,SF,24,MIA,16,0,235,41,79,0.519,27,64,0.42200000000000000,14,15,0.9330000000000000,0.69,7,9,0.778,1,16,17,8,2,0,3,19,116
Edmond Sumner,SG,25,IND,16,4,150,24,48,0.5,5,16,0.313,19,32,0.594,0.552,9,14,0.643,6,15,21,8,8,1,10,17,62
Jae'Sean Tate,SF,25,HOU,28,18,763,112,204,0.5490000000000000,19,58,0.32800000000000000,93,146,0.637,0.596,33,46,0.7170000000000000,46,96,142,50,25,17,33,83,276
Jayson Tatum,SF,22,BOS,23,23,810,215,479,0.449,63,162,0.389,152,317,0.479,0.515,101,114,0.8860000000000000,13,148,161,108,29,9,56,43,594
Jeff Teague,PG,32,BOS,23,3,397,42,130,0.32300000000000000,16,38,0.42100000000000000,26,92,0.28300000000000000,0.385,27,30,0.9,7,30,37,46,21,3,25,24,127
Garrett Temple,SG,34,CHI,26,5,715,84,197,0.426,40,111,0.36,44,86,0.512,0.528,22,27,0.815,13,67,80,51,28,13,27,63,230
Tyrell Terry,PG,20,DAL,11,0,56,5,16,0.313,0,7,0.0,5,9,0.556,0.313,1,3,0.33300000000000000,0,6,6,6,5,0,2,2,11
Daniel Theis,C,28,BOS,26,21,623,96,168,0.5710000000000000,23,58,0.397,73,110,0.664,0.64,28,41,0.6830000000000000,34,99,133,36,15,26,27,74,243
Brodric Thomas,SG,24,HOU,4,0,24,2,7,0.28600000000000000,1,6,0.16700000000000000,1,1,1.0,0.35700000000000000,5,7,0.7140000000000000,1,3,4,4,1,1,4,5,10
Matt Thomas,SG,26,TOR,15,0,100,13,33,0.39400000000000000,10,24,0.41700000000000000,3,9,0.33300000000000000,0.545,4,4,1.0,1,9,10,7,2,0,4,6,40
Tristan Thompson,PF,29,BOS,26,21,586,74,146,0.507,0,2,0.0,74,144,0.514,0.507,33,54,0.611,76,140,216,21,9,9,24,58,181
Sindarius Thornwell,SG,26,NOP,10,1,51,5,12,0.41700000000000000,3,6,0.5,2,6,0.33300000000000000,0.542,0,2,0.0,1,2,3,2,4,0,1,3,13
Matisse Thybulle,SG,23,PHI,26,1,461,32,83,0.386,15,52,0.28800000000000000,17,31,0.5480000000000000,0.47600000000000000,6,12,0.5,8,26,34,20,41,22,8,53,85
Xavier Tillman Sr.,PF,22,MEM,19,6,402,65,119,0.546,9,24,0.375,56,95,0.589,0.584,12,16,0.75,26,59,85,31,19,12,17,48,151
Obi Toppin,PF,22,NYK,20,0,240,40,83,0.48200000000000000,11,37,0.297,29,46,0.63,0.5480000000000000,7,10,0.7,5,43,48,9,4,9,10,17,98
Juan Toscano-Anderson,SG,27,GSW,16,10,349,42,75,0.56,11,26,0.423,31,49,0.633,0.633,10,14,0.7140000000000000,12,64,76,36,9,11,17,36,105
Karl-Anthony Towns,C,25,MIN,9,9,298,69,136,0.507,18,42,0.429,51,94,0.5430000000000000,0.574,40,43,0.93,28,67,95,30,9,17,25,30,196
Gary Trent Jr.,SG,22,POR,26,13,785,143,325,0.44,84,188,0.447,59,137,0.431,0.569,29,37,0.784,13,42,55,36,19,4,17,39,399
P.J. Tucker,PF,35,HOU,26,26,780,42,112,0.375,24,73,0.32900000000000000,18,39,0.462,0.48200000000000000,14,17,0.8240000000000000,26,94,120,36,22,14,27,79,122
Myles Turner,C,24,IND,27,27,842,126,253,0.498,39,120,0.325,87,133,0.654,0.575,66,85,0.7760000000000000,34,143,177,27,29,94,37,98,357
Jonas Valan?i?nas,C,28,MEM,19,18,522,124,212,0.585,8,21,0.381,116,191,0.607,0.604,58,77,0.753,61,144,205,39,12,15,41,62,314
Denzel Valentine,SG,27,CHI,23,3,462,73,188,0.38800000000000000,43,114,0.377,30,74,0.405,0.503,6,6,1.0,8,82,90,41,17,1,13,29,195
Jarred Vanderbilt,PF,21,MIN,27,10,517,68,113,0.602,1,2,0.5,67,111,0.604,0.606,26,51,0.51,50,112,162,47,30,18,25,60,163
Fred VanVleet,SG,26,TOR,29,29,1060,199,480,0.415,95,252,0.377,104,228,0.456,0.514,95,106,0.8960000000000000,20,103,123,193,49,20,60,67,588
Devin Vassell,SF,20,SAS,26,1,451,50,126,0.397,25,63,0.397,25,63,0.397,0.496,18,21,0.857,16,67,83,28,29,9,12,32,143
Gabe Vincent,PG,24,MIA,19,5,303,41,117,0.35,17,71,0.239,24,46,0.522,0.423,15,17,0.882,3,18,21,27,8,1,18,36,114
Nikola Vu?evi?,C,30,ORL,29,29,974,271,569,0.47600000000000000,75,181,0.414,196,388,0.505,0.542,62,76,0.816,60,276,336,100,32,16,49,50,679
Dean Wade,PF,24,CLE,23,0,192,17,49,0.34700000000000000,11,33,0.33300000000000000,6,16,0.375,0.45900000000000000,4,5,0.8,8,21,29,10,5,2,10,16,49
Moritz Wagner,C,23,WAS,14,3,191,32,54,0.593,6,18,0.33300000000000000,26,36,0.722,0.648,16,25,0.64,6,37,43,13,9,4,8,36,86
Kemba Walker,PG,30,BOS,13,13,364,71,195,0.364,34,95,0.358,37,100,0.37,0.451,37,41,0.902,7,41,48,52,14,2,29,17,213
Lonnie Walker,SG,22,SAS,25,22,666,101,249,0.406,39,110,0.355,62,139,0.446,0.484,28,35,0.8,5,68,73,42,12,9,26,53,269
John Wall,PG,30,HOU,19,19,591,141,320,0.441,39,111,0.35100000000000000,102,209,0.488,0.502,67,90,0.7440000000000000,10,60,70,119,19,13,66,26,388
Brad Wanamaker,PG,31,GSW,29,0,465,39,116,0.336,10,45,0.222,29,71,0.408,0.379,38,43,0.884,6,46,52,77,23,4,24,42,126
T.J. Warren,SF,27,IND,4,4,117,27,51,0.529,0,7,0.0,27,44,0.614,0.529,8,10,0.8,2,12,14,5,2,0,4,16,62
P.J. Washington,PF,22,CHA,24,24,691,97,231,0.42,26,79,0.32900000000000000,71,152,0.467,0.47600000000000000,48,65,0.738,40,117,157,73,22,31,49,65,268
Yuta Watanabe,SF,26,TOR,19,0,228,18,51,0.353,12,28,0.429,6,23,0.261,0.47100000000000000,8,8,1.0,16,45,61,7,9,12,8,20,56
Tremont Waters,PG,23,BOS,9,1,90,6,27,0.222,3,12,0.25,3,15,0.2,0.278,7,8,0.875,2,6,8,25,5,0,13,6,22
Quinndary Weatherspoon,SG,24,SAS,5,0,24,1,5,0.2,0,1,0.0,1,4,0.25,0.2,2,2,1.0,0,2,2,3,1,0,6,7,4
Russell Westbrook,PG,32,WAS,19,19,631,138,340,0.406,23,78,0.295,115,262,0.439,0.44,60,97,0.619,34,145,179,181,16,7,94,54,359
Coby White,PG,20,CHI,27,27,904,150,372,0.40300000000000000,64,183,0.35,86,189,0.455,0.489,52,60,0.867,9,119,128,146,10,3,66,65,416
Derrick White,SG,26,SAS,8,4,189,34,86,0.395,15,44,0.341,19,42,0.452,0.483,11,15,0.733,1,13,14,31,8,8,7,18,94
Hassan Whiteside,C,31,SAC,21,0,311,72,120,0.6,0,1,0.0,72,119,0.605,0.6,28,53,0.528,31,88,119,10,6,29,22,37,172
Andrew Wiggins,PF,25,GSW,29,29,934,195,417,0.46800000000000000,56,150,0.373,139,267,0.521,0.535,67,100,0.67,30,108,138,61,20,38,53,71,513
Grant Williams,PF,22,BOS,24,6,462,46,102,0.451,22,53,0.415,24,49,0.49,0.5590000000000000,15,29,0.517,24,49,73,23,11,10,23,71,129
Kenrich Williams,PF,26,OKC,28,6,512,65,121,0.537,15,34,0.441,50,87,0.575,0.599,12,19,0.632,40,70,110,48,21,5,25,48,157
Lou Williams,PG,34,LAC,28,3,626,123,291,0.423,30,79,0.38,93,212,0.439,0.474,70,82,0.8540000000000000,11,57,68,110,23,3,43,29,346
Patrick Williams,PF,19,CHI,26,26,720,96,211,0.455,23,58,0.397,73,153,0.47700000000000000,0.509,47,59,0.797,23,96,119,28,19,18,39,59,262
Robert Williams,C,23,BOS,21,0,317,56,77,0.727,0,1,0.0,56,76,0.737,0.727,16,24,0.667,46,65,111,16,22,24,22,34,128
Zion Williamson,PF,20,NOP,27,27,880,260,421,0.618,6,16,0.375,254,405,0.627,0.625,150,209,0.718,65,118,183,83,28,19,62,70,676
D.J. Wilson,PF,24,MIL,10,0,94,14,37,0.37800000000000000,8,23,0.348,6,14,0.429,0.486,1,2,0.5,3,19,22,3,1,3,4,12,37
Dylan Windler,SF,24,CLE,15,0,262,31,65,0.47700000000000000,13,42,0.31,18,23,0.7830000000000000,0.5770000000000000,15,17,0.882,11,45,56,18,9,8,15,19,90
Cassius Winston,PG,22,WAS,6,0,44,4,10,0.4,3,7,0.429,1,3,0.33300000000000000,0.55,2,2,1.0,0,4,4,6,0,1,1,4,13
James Wiseman,C,19,GSW,20,16,419,98,195,0.503,9,22,0.409,89,173,0.514,0.526,38,61,0.623,30,92,122,14,8,26,32,63,243
Christian Wood,C,25,HOU,17,17,530,149,267,0.5580000000000000,32,76,0.42100000000000000,117,191,0.613,0.618,44,64,0.688,31,143,174,22,16,26,31,32,374
Robert Woodard,SF,21,SAC,6,0,17,6,11,0.545,1,3,0.33300000000000000,5,8,0.625,0.591,0,2,0.0,3,5,8,0,0,0,1,0,13
Delon Wright,SG,28,DET,28,23,823,104,228,0.456,24,68,0.353,80,160,0.5,0.509,62,79,0.785,32,98,130,137,40,15,34,30,294
Thaddeus Young,PF,32,CHI,23,0,592,118,201,0.5870000000000000,5,21,0.23800000000000000,113,180,0.628,0.6,17,34,0.5,56,78,134,101,32,11,47,67,258
Trae Young,PG,22,ATL,26,26,901,197,459,0.429,59,160,0.369,138,299,0.462,0.493,235,265,0.887,18,82,100,241,20,7,111,53,688
Cody Zeller,C,28,CHA,15,12,361,63,120,0.525,3,16,0.188,60,104,0.5770000000000000,0.5380000000000000,22,29,0.759,39,81,120,37,10,9,14,37,151
Ivica Zubac,C,23,LAC,30,1,586,95,142,0.669,0,1,0.0,95,141,0.674,0.669,60,71,0.845,67,131,198,32,11,24,30,78,250